333333333333333333-
300000000000000003-
300000000000000003-
300000000000000003-
222222222222222222-
300000000000000003-
300000000000000003-
300000000000000003-
300000000000000003-
333333333333333333